#####B##
#     ##
### ####
### ## #
##     #
##A#####